###########
#    # #   
# #  ######
# #     # #
# ### ### #
#  #      #
#  ## # # #
#  #Z # # #
## ###### #
#    #    #
#    # ####
## ###  #  
#    #  # #
# #### ####
#A         
###########